SS             SS  S
  S S XXXS S  S     
    XXXSX  S  SS S 
XXXXX   XXXXXXS     
  S X   S  S XX   S 
  SXX         XXX   
  S XXXXXXXXX   X  S
    SXS     X  XX S 
          XXXXXXX S 
   S   S  X       SS
     S S  XXX   S S 
 S   S    SSX   S S 
  SSS    S  XS      
 S   S  XXXXX   SS  
 S S S  SX S  SS SS 
 S   XX  X     S SS 
 SSSSSXXXXXS   S  S 
 SS SS  S W    SSSS 
      S    S   S  SS
             S      
